1111111111111111111111111111111111
1E0000000000000C00001C100000000001
1010010100100000101000000000110101
1010010010101C10001001000001C10101
1P0000000C00C0000000000000010000C1
1000000000000000000000000010001001
1111111111111111111111111111111111