1111111111111111111111111111111111
1E000000C000000C00000C000100C00001
1100111100100000101001000100010101
1P11000010101010001001000100000001
1010010010101010001001000100010101
1010010010101010001001000100000001
1010010010101010001001000100010101
10100010101010100010010C0100010101
10C001000C00C00000000000C0010000C1
1111111111111111111111111111111111