11111111111111111111111111111111111111111
1P0000E0000000000000000000000000000000001
10000000000000000000000000000000000000001
10000000000000000000000000000000000000001
10000000000000000000010000000000000000001
10000000000000000000000000000000000000001
10000000000000000000000000000000000000001
10000000000000000010000000000000000000001
10000000000000000010000000000000000000001
10000000000000000010000000000000000000001
10000000000000000010000000000000000000001
10000000000000000010000000000000000000001
10000000000000000010000000000000000000001
10000000000000000010000000000000000000001
10000000000000000010000000000000000000001
10000000000000000010000000000000000000001
10000000000000000010000000000000000000001
10000000000000000000000000000000000000001
10000000000000000000000000000000000000001
100000000000000000001000000000000C0000001
10000000000000000000000000000000000000001
11111111111111111111111111111111111111111