111111111111111111111111111
100000000C000000000000C0001
1110000C01P1110000C00000111
100000011100010000001110001
1000011101000100001110100C1
100000E00001010000000000101
111111111111111111111111111