1111111111111111111111111111111111
1E000000C000000C00000C000100C000D1
1100111100100000101001000100010101
1P110000101D1010001001000100000001
1010010010101010001001000100010101
1010010010101010001001000100000001
1010D10010101010001001000100010101
10100010101010100010010C0100010101
10C001000C00C000D0000000C0010000C1
1111111111111111111111111111111111